G G G G G G G G G G G G G G G
N N N N N N N N N N N N N N N
G G G G G G G G G G G G G G G
C C C C C C C C C C C C C C C
G G G G G G G G G G G G G G G